Serial_LCD	KEYWORD1
ProxySerial	KEYWORD1
button	KEYWORD1
item	KEYWORD1
gClock	KEYWORD1
gDirection	KEYWORD1

WhoAmI	KEYWORD2
begin	KEYWORD2
setSpeed	KEYWORD2
clear	KEYWORD2
setBacklight	KEYWORD2
setDisplay	KEYWORD2
setContrast	KEYWORD2
setOrientation	KEYWORD2
getOrientation	KEYWORD2
setTouch	KEYWORD2
setVolume	KEYWORD2
setBackGroundColour	KEYWORD2
off	KEYWORD2
line	KEYWORD2
dLine	KEYWORD2
circle	KEYWORD2
triangle	KEYWORD2
rectangle	KEYWORD2
dRectangle	KEYWORD2
ellipse	KEYWORD2
setPenSolid	KEYWORD2
setFont	KEYWORD2
setFontSolid	KEYWORD2
readPixel	KEYWORD2
tText	KEYWORD2
gText	KEYWORD2
getTouchActivity	KEYWORD2
getTouchXY	KEYWORD2
detectTouchRegion	KEYWORDS2
addColour	KEYWORD2
splitColour	KEYWORD2
halfColour	KEYWORD2
nacAck	KEYWORD2
fontX	KEYWORD2
fontY	KEYWORD2
maxX	KEYWORD2
maxY	KEYWORD2
prompt	KEYWORD2
define	KEYWORD2
dDefine	KEYWORD2
dStringDefine	KEYWORD2
stringDefine	KEYWORD2
draw	KEYWORD2
enable	KEYWORD2
check	KEYWORD2
initSD	KEYWORD2
dSaveScreenSD	KEYWORD2
saveScreenSD	KEYWORD2
readScreenSD	KEYWORD2
playSoundSD	KEYWORD2
setColour	KEYWORD2
splitColour	KEYWORD2
halfColour	KEYWORD2
nacAck	KEYWORD2
fontX	KEYWORD2
fontY	KEYWORD2
maxX	KEYWORD2
maxY	KEYWORD2
dDetectTouchRegion	KEYWORD2
detectTouchRegion	KEYWORD2
getIndex	KEYWORD2
saveScreenRAW	KEYWORD2
dSaveScreenRAW	KEYWORD2
saveScreenRAW	KEYWORD2
readScreenRAW	KEYWORD2
getSectors	KEYWORD2
saveScreenFAT	KEYWORD2
dSaveScreenFAT	KEYWORD2
readScreenFAT	KEYWORD2
checkSD	KEYWORD2
checkRAW	KEYWORD2
setRAW	KEYWORD2
protectFAT	KEYWORD2
readTextFile	KEYWORD2
writeStringFile	KEYWORD2
appendStringFile	KEYWORD2
eraseFile	KEYWORD2
findFile	KEYWORD2
setItem	KEYWORD2
state	KEYWORD2
dLabel	KEYWORD2
label	KEYWORD2
dialog	KEYWORD2
menu	KEYWORD2
setResolutionVGA	KEYWORD2
checkScreenType	KEYWORD2
replaceBackGroundColour	KEYWORD2
checkHardwareVersion	KEYWORD2
checkSoftwareVersion	KEYWORD2

_lcd_nss	LITERAL1
_font	LITERAL1
_fontX	LITERAL1
_fontY	LITERAL1
_maxX	LITERAL1
_maxY	LITERAL1
_touch_buffer	LITERAL1
_uIntPrint	LITERAL1
_swap	LITERAL1
_bytePrint	LITERAL1
_stringPrint	LITERAL1
_byteRead	LITERAL1
_serialAvailable	LITERAL1
_serialFlush	LITERAL1
_pscreen	LITERAL1
_checkedSD	LITERAL1
_checkedRAW	LITERAL1
_serialSoftFlag	LITERAL1
_orientation	LITERAL1
_checkedScreenType	LITERAL1